{
  "rooms": [
    {
      "x1": 21,
      "y1": 20,
      "x2": 27,
      "y2": 28,
      "cx": 24,
      "cy": 24,
      "id": 0
    },
    {
      "x1": 25,
      "y1": 8,
      "x2": 34,
      "y2": 16,
      "cx": 30,
      "cy": 12,
      "id": 1
    },
    {
      "x1": 38,
      "y1": 15,
      "x2": 43,
      "y2": 23,
      "cx": 41,
      "cy": 19,
      "id": 2
    },
    {
      "x1": 10,
      "y1": 29,
      "x2": 17,
      "y2": 36,
      "cx": 14,
      "cy": 33,
      "id": 3
    },
    {
      "x1": 21,
      "y1": 39,
      "x2": 29,
      "y2": 44,
      "cx": 25,
      "cy": 42,
      "id": 4
    },
    {
      "x1": 10,
      "y1": 15,
      "x2": 17,
      "y2": 23,
      "cx": 14,
      "cy": 19,
      "id": 5
    },
    {
      "x1": 34,
      "y1": 27,
      "x2": 42,
      "y2": 35,
      "cx": 38,
      "cy": 31,
      "id": 6
    },
    {
      "x1": 16,
      "y1": 6,
      "x2": 21,
      "y2": 11,
      "cx": 19,
      "cy": 9,
      "id": 7
    },
    {
      "x1": 41,
      "y1": 4,
      "x2": 47,
      "y2": 11,
      "cx": 44,
      "cy": 8,
      "id": 8
    },
    {
      "x1": 1,
      "y1": 16,
      "x2": 6,
      "y2": 21,
      "cx": 4,
      "cy": 19,
      "id": 9
    },
    {
      "x1": 34,
      "y1": 39,
      "x2": 39,
      "y2": 47,
      "cx": 37,
      "cy": 43,
      "id": 10
    },
    {
      "x1": 4,
      "y1": 40,
      "x2": 10,
      "y2": 46,
      "cx": 7,
      "cy": 43,
      "id": 11
    },
    {
      "x1": 3,
      "y1": 6,
      "x2": 10,
      "y2": 11,
      "cx": 7,
      "cy": 9,
      "id": 12
    }
  ]
}